gleich=subito
leider=purtroppo
Getränke=bevande
ein=uno
immer=sempre
hinterlassen=lasciare
Heute=oggi
dann=dunque
schläft=dormire
noch=ancora
zwei=due
sicher=sicuramente
spät=tardi
drei=tre
etwas=qualcosa
dort=la`
gern=volentieri
also=allora
sofort=subito
denn=allora
Bröt=pane
sehon=gia`
auch=anche
weiter=continuare
Abend=sera
genug=abbastanza
warum=perche`
Tag=giorno
da=qui
rot=rosso
blau=blu
schwarz=nero
