to hear=udire
bee=ape
to feel=sentire
to do=fare
friendly=amichevole
their=loro
to leave=lasciare
your=tuo
two=due
three=tre
boy=ragazzo
to fly=volare
tea=the
beautiful=bellissimo
mouse=topo
men=uomo
cat=gatto
bird=uccello
bear=orso
to be=essere
to have=avere
more=piu`
to give=dare
one=uno
less=meno
my=mio
girl=ragazza
the=il
horse=cavallo
eagle=aquila
to take=prendere
dog=cane
